{
    "35": "C",
    "36": "D",
    "37": "E",
    "38": "F",
    "39": "G",
    "40": "A",
    "41": "B",
    "42": "c",
    "43": "d",
    "44": "e",
    "45": "f",
    "46": "g",
    "47": "a",
    "48": "b",
    "49": "c'",
    "50": "d'",
    "51": "e'",
    "52": "c'",
    "53": "e'",
    "54": "g",
    "55": "c'",
    "56": "e'",
    "57": "c'",
    "59": "e'"
}
